#domain
hospital
#levelname
MAPF02
#colors
blue: 0,1,2,3
#initial
+++++++++++++
+0    1  3  +
+        ++++
+           +
+     2  ++ +
+         + +
+++++++++++++
#goal
+++++++++++++
+  0       3+
+        ++++
+     1     +
+   2    ++ +
+         + +
+++++++++++++
#end