#domain
hospital
#levelname
Communication27
#colors
blue: 0, 3, A
red: 1, 2
#initial
+++++++++++++++++++++++++
++++                 ++++
++++                 ++++
++++                 ++++
++++        3 0      ++++
++++++++A+++++++++A++++++
++++++++    +++++    ++++
++++++++   1+++++   2++++
+++++++++++++++++++++++++
#goal
+++++++++++++++++++++++++
++++                 ++++
++++  1             2++++
++++                 ++++
++++                 ++++
++++++++ +++++++++ ++++++
++++++++    +++++    ++++
++++++++    +++++    ++++
+++++++++++++++++++++++++
#end
