#domain
hospital
#levelname
Communication12
#colors
blue: 0, A
red: 1
#initial
+++++++++++++++++++++++++
++++                 ++++
++++                 ++++
++++                 ++++
++++                 ++++
++++++++A++++++ +++++++++
++++++++    ++++++++++++
++++++++1     0++++++++++
+++++++++++++++++++++++++
#goal
+++++++++++++++++++++++++
++++                A++++
++++                 ++++
++++  1              ++++
++++                 ++++
++++++++ ++++++ +++++++++
++++++++    ++++++++++++
++++++++       ++++++++++
+++++++++++++++++++++++++
#end
