#domain
hospital
#levelname
Communication32
#colors
blue: 0, A
red: 1
#initial
+++++++++++++++++++++++++
++++                 ++++
++++                 ++++
++++                 ++++
++++          0      ++++
++++++++A+++++++++ ++++++
++++++++    +++++    ++++
++++++++   1+++++    ++++
+++++++++++++++++++++++++
#goal
+++++++++++++++++++++++++
++++                 ++++
++++  1              ++++
++++                 ++++
++++   A             ++++
++++++++ +++++++++ ++++++
++++++++    +++++    ++++
++++++++    +++++    ++++
+++++++++++++++++++++++++
#end
