#domain
hospital
#levelname
Communication23
#colors
blue: 0, A
red: 1
#initial
+++++++++++++++++++++++++
++++       0      A  ++++
++++                 ++++
++++                 ++++
++++                 ++++
++++++++A++++++ +++++++++
++++++++    ++++++++++++
++++++++   1+++++++++++++
+++++++++++++++++++++++++
#goal
+++++++++++++++++++++++++
++++                A++++
++++                 ++++
++++  1              ++++
++++                 ++++
++++++++ ++++++ +++++++++
++++++++    ++++++++++++
++++++++    +++++++++++++
+++++++++++++++++++++++++
#end
