#domain
hospital
#levelname
Communication14
#colors
blue: 0, A
red: 1, 2, 3, 4
#initial
+++++++++++++++++++++++++
++++       0         ++++
++++  4              ++++
++++  2              ++++
++++  3              ++++
++++++++A++++++ +++++++++
++++++++    ++++++++++++
++++++++   1+++++++++++++
+++++++++++++++++++++++++
#goal
+++++++++++++++++++++++++
++++                A++++
++++              4  ++++
++++  1           3  ++++
++++              2  ++++
++++++++ ++++++ +++++++++
++++++++    ++++++++++++
++++++++    +++++++++++++
+++++++++++++++++++++++++
#end
