#domain
hospital
#levelname
Custom
#colors
blue: 0, A, C, E, H
red: 1, B, F, G, J
green: 2, D, X, I
#initial
+++++++++++
+ X0    X +
+ +++X+++ +
+ +     + +
+ + + + + +
+ +A+ + + +
+ +B+ + + +
+ +C+ + + +
+ +D+ + + +
+ +E+ + + +
+ +++++++ +
+ X1    X2+
+ +++X+++ +
+ +     + +
+ + + + + +
+ +F+ + + +
+ +G+ + + +
+ +H+ + + +
+ +I+ + + +
+ +J+ + + +
+ +++++++ +
+         +
+         +
+++++++++++
#goal
+++++++++++
+         +
+ +++ +++ +
+ +     + +
+ + + + + +
+ + + +F+ +
+ + + +B+ +
+ + + +A+ +
+ + + +C+ +
+ + +1+D+ +
+ +++++++ +
+        2+
+ +++ +++ +
+ +     + +
+ + + + + +
+ + + +H+ +
+ + + +G+ +
+ + + +E+ +
+ + + +I+ +
+ + +0+J+ +
+ +++++++ +
+         +
+         +
+++++++++++
#end
