#domain
hospital
#levelname
MACustom_1
#colors
blue: 0, A
red: 1, B
#initial
++++++++++++++++++++++++++
+    +              +    +
+  B +              +    +
+    +              +   0+
+    +              +    +
+                        +
+    +              +    +
+    +              +++A++
+    +              +  1 +
++++++++++++++++++++++++++
#goal
++++++++++++++++++++++++++
+    +              +    +
+    +              +    +
+    +              +    +
+    +              +   0+
+                   B    +
+    +              +    +
+    +              +++ ++
+    +              + 1A +
++++++++++++++++++++++++++
#end
