#domain
hospital
#levelname
MATest2
#colors
blue: 0, 1
red: 2
green: 3, 4
cyan: 5, 6, 7
#initial
+++++++++++++++++++
+4   30      2    +
+        6     ++++
+ +               +
+ +        ++++++ +
+1+  5    7+      +
+++++++++++++++++++
#goal
+++++++++++++++++++
+5               2+
+              ++++
+ +          4    +
+ +        ++++++ +
+7+3  6    +01    +
+++++++++++++++++++
#end
