#domain
hospital
#levelname
MATest
#colors
blue: 0, A
red: 1, B 
green: 2, C
#initial
+++++++++++++++++++
+0               2+
+              ++++
+ +               +
+C+  1     ++++++A+
+B+        +      +
+++++++++++++++++++
#goal
+++++++++++++++++++
+                 +
+              ++++
+2+               +
+1+        ++++++B+
+0+        +A    C+
+++++++++++++++++++
#end
