#domain
hospital
#levelname
MATest3
#colors
blue: 0, 1
red: 2
#initial
+++++++++++++++++++
+            2    +
+    0         ++++
+ +               +
+ +  1     ++++++ +
+ +        +      +
+++++++++++++++++++
#goal
+++++++++++++++++++
+                2+
+              ++++
+ +               +
+ +        ++++++ +
+ +        +01    +
+++++++++++++++++++
#end
