#domain
hospital
#levelname
SAD2
#colors
blue: 0, A
red: 1, B
green: 2
#initial
+++++++++++++++++++
+0             1B +
+A     2       ++++
+                 +
+          B   ++ +
+               + +
+++++++++++++++++++
#goal
+++++++++++++++++++
+                B+
+              ++++
+                2+
+              ++B+
+               +A+
+++++++++++++++++++
#end
