#domain
hospital
#levelname
RSC1
#colors
blue: 0, 1, A
#initial
+++++++++++++++++++
+ +               +
+++++++++++++     +
+1          +     +
+++++ +++++++++++++
+  0 A          +++
+++++++++++++++++++
#goal
+++++++++++++++++++
+ +               +
+++++++++++++     +           
+           +     +
+++++ +++++++++++++          
+            1 0+++
+++++++++++++++++++
#end
