#domain
hospital
#levelname
RSC3
#colors
blue: 0, 1, A
#initial
+++++++++++++++++++
+ +               +
+++++++++++++     +
+  1        +     +
++++ ++++++++++++++
+0  A           +++
+++++++++++++++++++
#goal
+++++++++++++++++++
+ +               +
+++++++++++++     +           
+           +     +
++++ ++++++++++++++          
+            1 0+++
+++++++++++++++++++
#end
