#domain
hospital
#levelname
RSC4
#colors
blue: 0, 1, 2, A
#initial
+++++++++++++++++
+1          ++ ++
++++ +++++++++ ++
+0  A           +
++++++++++++ ++++
+   2           +
+++++++++++++++++
#goal
+++++++++++++++++
+           ++2++
++++ +++++++++ ++
+            1 0+
++++++++++++ ++++
+               +
+++++++++++++++++
#end
