#domain
hospital
#levelname
RSC5
#colors
blue: 0, 1, A
#initial
+++++++++++++++++++
+ +               +
+++++++++++++     +
+  1        +     +
++++A++++++++++++++
++++A++++++++++++++
+  0            +++
+++++++++++++++++++
#goal
+++++++++++++++++++
+ +               +
+++++++++++++     +           
+          0+     +
++++ ++++++++++++++
++++ ++++++++++++++          
+              1+++
+++++++++++++++++++
#end
