#domain
hospital
#levelname
SAchoice
#colors
blue: 0, A
red: 1, B
#initial
+++++++++++++
+         A +
+           +
+           +
+           +
+1          +
+0      B   +
+++++++++++++

#goal
+++++++++++++
+           +
+          A+
+           +
+           +
+           +
+          B+
+++++++++++++

#end
