#domain
hospital
#levelname
SACustom
#colors
blue: 0, A, B, C, D
#initial
+++++++++++++++++++++++++
+      +++    +++       +
+      +B+    +D+       +
++++++++A++++++C+++++++++
++++                 ++++
++                     ++
++++                 ++++
++++      0          ++++
++++                 ++++
++                     ++
++++                 ++++
++++++++ ++++++ +++++++++
++++++++ ++++++ +++++++++
+++++++++++++++++++++++++
+++++++++++++++++++++++++
#goal
+++++++++++++++++++++++++
+      +++    +++       +
+      + +    + +       +
++++++++ ++++++ +++++++++
++++                 ++++
++BA                   ++
++++                 ++++
++++                 ++++
++++                 ++++
++                     ++
++++                 ++++
++++++++ ++++++C+++++++++
++++++++ ++++++D+++++++++
+++++++++++++++++++++++++
+++++++++++++++++++++++++
#end
