#domain
hospital
#levelname
SACustom
#colors
blue: 0, A, B, C, D
#initial
+++    +++
       +++    +++
       +B+    +D+
++++++++A++++++C+++++++++
++++                 ++++
++                     ++
++++                 ++++
++++      0          ++++
++++                 ++++
++                     ++
++++                 ++++
++++++++ ++++++ +++++++++
++++++++ ++++++ +++++++++
+++++++++++++++++++++++++
+++++++++++++++++++++++++
#goal
+++    +++
       +++    +++
       + +    + +
++++++++ ++++++ +++++++++
++++                 ++++
++AB                   ++
++++                 ++++
++++                 ++++
++++                 ++++
++                     ++
++++                 ++++
++++++++ ++++++D+++++++++
++++++++ ++++++C+++++++++
+++++++++++++++++++++++++
+++++++++++++++++++++++++
#end
