#domain
hospital
#levelname
SACustom
#colors
blue: 0, A
red: 1
#initial
+++++++++++++++++++++++++
++++   1             ++++
++++                 ++++
++++                 ++++
++++          0      ++++
++++++++A++++++ +++++++++
++++++++    ++++++++++++
++++++++    +++++++++++++
+++++++++++++++++++++++++
#goal
+++++++++++++++++++++++++
++++                0++++
++++                 ++++
++++      A          ++++
++++                 ++++
++++++++ ++++++ +++++++++
++++++++    ++++++++++++
++++++++    +++++++++++++
+++++++++++++++++++++++++
#end
