#domain
hospital
#levelname
communication
#colors
blue: 0
red: 1, A
#initial
+++++++++++++++++++
++++           ++++
++++        1  ++++
++++++++A++++++++++
++++++++    +++++++
++++++++   0+++++++
+++++++++++++++++++
#goal
+++++++++++++++++++
++++      A    ++++
++++           ++++
++++++++ ++++++++++
++++++++    +++++++
++++++++    +++++++
+++++++++++++++++++
#end
