#domain
hospital
#levelname
SACustom
#colors
blue: 0
red: 1, A
#initial
+++++++++++++++++++++++++
++++                 ++++
++++                 ++++
++++                 ++++
++++          1      ++++
++++++++A++++++ +++++++++
++++++++    ++++++++++++
++++++++  0 +++++++++++++
+++++++++++++++++++++++++
#goal
+++++++++++++++++++++++++
++++                1++++
++++                 ++++
++++      A          ++++
++++                 ++++
++++++++ ++++++ +++++++++
++++++++    ++++++++++++
++++++++    +++++++++++++
+++++++++++++++++++++++++
#end
